NO texture/north_texture.xpm
SO texture/south_texture.xpm
WE texture/west_texture.xpm
EA texture/east_texture.xpm
F 128,223,255
C 225,30,0

1111
1111